efficitur : [Efficitur]
elementum : [Elementum]
commodo : [Commodo]
purus : [Purus]
lorem : [Lorem]
leo : [Leo]
maximus, : [Maximus,]
volutpat : [Volutpat]
ac : [Ac]
ad : [Ad]
augue, : [Augue,]
at : [At]
Sed : [Sed]
risus, : [Risus,]
pellentesque : [Pellentesque]
ipsum : [Ipsum]
amet, : [Amet,]
elit : [Elit]
taciti : [Taciti]
felis, : [Felis,]
ridiculus : [Ridiculus]
lorem, : [Lorem,]
penatibus : [Penatibus]
arcu : [Arcu]
conubia : [Conubia]
sed : [Sed]
dictum : [Dictum]
nostra, : [Nostra,]
dapibus : [Dapibus]
pulvinar : [Pulvinar]
interdum : [Interdum]
ultricies : [Ultricies]
a : [A]
magnis : [Magnis]
aliquam : [Aliquam]
ornare : [Ornare]
magna : [Magna]
semper, : [Semper,]
facilisis, : [Facilisis,]
Praesent : [Praesent]
Lorem : [Lorem]
malesuada : [Malesuada]
sapien : [Sapien]
himenaeos : [Himenaeos]
quis : [Quis]
sagittis : [Sagittis]
maximus : [Maximus]
sodales, : [Sodales,]
suscipit : [Suscipit]
egestas : [Egestas]
dis : [Dis]
euismod : [Euismod]
nascetur : [Nascetur]
viverra, : [Viverra,]
imperdiet : [Imperdiet]
molestie : [Molestie]
ut : [Ut]
consequat : [Consequat]
varius : [Varius]
vulputate : [Vulputate]
fermentum : [Fermentum]
litora : [Litora]
et : [Et]
pharetra, : [Pharetra,]
eu : [Eu]
lacus : [Lacus]
mattis : [Mattis]
vitae : [Vitae]
tempor, : [Tempor,]
Class : [Class]
felis : [Felis]
fringilla, : [Fringilla,]
Ut : [Ut]
blandit : [Blandit]
pharetra : [Pharetra]
nisi, : [Nisi,]
eget, : [Eget,]
Aenean : [Aenean]
tempus : [Tempus]
Mauris : [Mauris]
pretium, : [Pretium,]
non, : [Non,]
non : [Non]
risus : [Risus]
Fusce : [Fusce]
sit : [Sit]
montes, : [Montes,]
leo, : [Leo,]
purus, : [Purus,]
Donec : [Donec]
Nam : [Nam]
libero : [Libero]
eget : [Eget]
tempor : [Tempor]
mollis : [Mollis]
augue : [Augue]
turpis, : [Turpis,]
id : [Id]
Nulla : [Nulla]
per : [Per]
Maecenas : [Maecenas]
sodales : [Sodales]
Etiam : [Etiam]
in : [In]
velit : [Velit]
urna : [Urna]
sociosqu : [Sociosqu]
tellus, : [Tellus,]
luctus : [Luctus]
eros, : [Eros,]
aptent : [Aptent]
ullamcorper : [Ullamcorper]
vestibulum : [Vestibulum]
Morbi : [Morbi]
hendrerit, : [Hendrerit,]
congue : [Congue]
dolor : [Dolor]
inceptos : [Inceptos]
metus : [Metus]
et, : [Et,]
diam : [Diam]
nisi : [Nisi]
ipsum, : [Ipsum,]
quam : [Quam]
sagittis, : [Sagittis,]
tincidunt : [Tincidunt]
nisl : [Nisl]
ultrices : [Ultrices]
diam, : [Diam,]
condimentum : [Condimentum]
ut, : [Ut,]
turpis : [Turpis]
Aliquam : [Aliquam]
ante : [Ante]
placerat : [Placerat]
parturient : [Parturient]
rutrum : [Rutrum]
Vivamus : [Vivamus]
eu, : [Eu,]
porttitor : [Porttitor]
eros : [Eros]
tristique : [Tristique]
torquent : [Torquent]
adipiscing : [Adipiscing]
est : [Est]
cursus : [Cursus]
odio : [Odio]
eleifend : [Eleifend]
Orci : [Orci]
nec : [Nec]
scelerisque : [Scelerisque]
erat : [Erat]
nunc : [Nunc]
facilisis : [Facilisis]
tincidunt, : [Tincidunt,]
Vestibulum : [Vestibulum]
neque : [Neque]
natoque : [Natoque]
elit, : [Elit,]
mi : [Mi]
vel : [Vel]
feugiat : [Feugiat]
vitae, : [Vitae,]
enim : [Enim]
ligula : [Ligula]
lobortis : [Lobortis]
arcu, : [Arcu,]
Nullam : [Nullam]
tortor, : [Tortor,]
posuere : [Posuere]
urna, : [Urna,]
Duis : [Duis]
tellus : [Tellus]
Curabitur : [Curabitur]
orci : [Orci]
faucibus : [Faucibus]
massa : [Massa]
lacinia : [Lacinia]
venenatis : [Venenatis]
lectus : [Lectus]
curae; : [Curae;]
viverra : [Viverra]
primis : [Primis]
mus : [Mus]
hendrerit : [Hendrerit]
Phasellus : [Phasellus]
fringilla : [Fringilla]
cubilia : [Cubilia]
Quisque : [Quisque]
sollicitudin : [Sollicitudin]
quis, : [Quis,]
aliquet : [Aliquet]
amet : [Amet]
Nunc : [Nunc]
dui : [Dui]
enim, : [Enim,]
consectetur : [Consectetur]
nulla : [Nulla]
