tristique : [Tristique]
mollis : [Mollis]
elementum : [Elementum]
torquent : [Torquent, Torquent]
suscipit : [Suscipit]
est : [Est]
commodo : [Commodo]
egestas : [Egestas, Egestas]
nec : [Nec, Nec]
nunc : [Nunc]
erat : [Erat]
dis : [Dis]
euismod : [Euismod]
tincidunt, : [Tincidunt,]
Vestibulum : [Vestibulum]
leo : [Leo, Leo]
elit, : [Elit,]
maximus, : [Maximus,]
Nulla : [Nulla]
molestie : [Molestie]
mi : [Mi]
ac : [Ac, Ac]
lobortis : [Lobortis]
ligula : [Ligula, Ligula]
Etiam : [Etiam]
urna : [Urna]
velit : [Velit, Velit]
varius : [Varius, Varius]
vulputate : [Vulputate, Vulputate]
sociosqu : [Sociosqu, Sociosqu]
eu : [Eu, Eu]
luctus : [Luctus]
lacus : [Lacus]
mattis : [Mattis]
Sed : [Sed, Sed]
risus, : [Risus,]
tortor, : [Tortor,, Tortor,]
ipsum : [Ipsum, Ipsum]
Class : [Class, Class]
fringilla, : [Fringilla,]
elit : [Elit]
faucibus : [Faucibus, Faucibus]
taciti : [Taciti, Taciti]
blandit : [Blandit]
aptent : [Aptent, Aptent]
lectus : [Lectus]
ullamcorper : [Ullamcorper]
vestibulum : [Vestibulum]
Aenean : [Aenean, Aenean]
tempus : [Tempus]
ridiculus : [Ridiculus]
risus : [Risus, Risus]
dolor : [Dolor]
sed : [Sed, Sed]
metus : [Metus, Metus]
dictum : [Dictum]
Fusce : [Fusce]
dapibus : [Dapibus, Dapibus]
sit : [Sit, Sit]
ultricies : [Ultricies, Ultricies]
interdum : [Interdum, Interdum]
montes, : [Montes,]
leo, : [Leo,]
fringilla : [Fringilla]
ipsum, : [Ipsum,]
sagittis, : [Sagittis,]
quam : [Quam]
nisl : [Nisl]
tincidunt : [Tincidunt, Tincidunt]
aliquam : [Aliquam]
magna : [Magna, Magna]
semper, : [Semper,]
Praesent : [Praesent, Praesent]
placerat : [Placerat]
Aliquam : [Aliquam]
ante : [Ante, Ante]
parturient : [Parturient]
sapien : [Sapien, Sapien]
Nunc : [Nunc]
dui : [Dui, Dui]
quis : [Quis]
Nam : [Nam]
eu, : [Eu,]
nulla : [Nulla]
sagittis : [Sagittis, Sagittis]
maximus : [Maximus]
