tempor : [Tempor, Tempor]
efficitur : [Efficitur, Efficitur]
purus : [Purus, Purus]
augue : [Augue]
lorem : [Lorem, Lorem]
turpis, : [Turpis,]
id : [Id, Id]
per : [Per, Per]
Maecenas : [Maecenas, Maecenas]
volutpat : [Volutpat, Volutpat]
ad : [Ad, Ad]
sodales : [Sodales]
in : [In, In]
tellus, : [Tellus,]
augue, : [Augue,]
at : [At, At]
pellentesque : [Pellentesque]
amet, : [Amet,]
eros, : [Eros,]
felis, : [Felis,]
hendrerit, : [Hendrerit,]
Morbi : [Morbi, Morbi]
lorem, : [Lorem,]
congue : [Congue]
penatibus : [Penatibus]
arcu : [Arcu, Arcu]
conubia : [Conubia, Conubia]
inceptos : [Inceptos, Inceptos]
nostra, : [Nostra,, Nostra,]
et, : [Et,]
pulvinar : [Pulvinar]
diam : [Diam]
a : [A, A]
magnis : [Magnis]
nisi : [Nisi, Nisi]
diam, : [Diam,]
ultrices : [Ultrices, Ultrices]
condimentum : [Condimentum, Condimentum]
ornare : [Ornare, Ornare]
ut, : [Ut,]
facilisis, : [Facilisis,]
turpis : [Turpis, Turpis]
Lorem : [Lorem]
malesuada : [Malesuada]
rutrum : [Rutrum]
himenaeos : [Himenaeos, Himenaeos]
Vivamus : [Vivamus]
porttitor : [Porttitor]
sodales, : [Sodales,]
adipiscing : [Adipiscing]
cursus : [Cursus]
odio : [Odio]
Orci : [Orci]
scelerisque : [Scelerisque]
facilisis : [Facilisis, Facilisis]
nascetur : [Nascetur]
viverra, : [Viverra,]
imperdiet : [Imperdiet, Imperdiet]
natoque : [Natoque]
vel : [Vel, Vel]
feugiat : [Feugiat]
vitae, : [Vitae,]
ut : [Ut, Ut]
enim : [Enim]
consequat : [Consequat, Consequat]
fermentum : [Fermentum]
Nullam : [Nullam, Nullam]
litora : [Litora, Litora]
et : [Et, Et]
pharetra, : [Pharetra,]
tempor, : [Tempor,]
vitae : [Vitae]
posuere : [Posuere]
Duis : [Duis]
tellus : [Tellus]
felis : [Felis, Felis]
Curabitur : [Curabitur]
Ut : [Ut, Ut]
massa : [Massa]
lacinia : [Lacinia]
pharetra : [Pharetra]
venenatis : [Venenatis]
nisi, : [Nisi,]
mus : [Mus]
non, : [Non,]
non : [Non, Non]
hendrerit : [Hendrerit]
Phasellus : [Phasellus, Phasellus]
purus, : [Purus,]
sollicitudin : [Sollicitudin]
Quisque : [Quisque, Quisque]
Donec : [Donec, Donec]
aliquet : [Aliquet]
amet : [Amet, Amet]
libero : [Libero]
eget : [Eget, Eget]
consectetur : [Consectetur, Consectetur]
